#########################################
#EOOOOOOOOOOOOOOOOOOOOOOOOOOOOOOOOOOOOOE#
#OOOOOOOOOOOOOOOOOOOOOOOOOOOOOOOOOOOOOOO#
#OOXXXXXXXXXXXXXXXXXXXXXXXXXXXXXXXXXXXOO#
#OOXXXXXXXXXXXXXXXXXXXXXXXXXXXXXXXXXXXOO#
#OOXX                               XXOO#
#OOXX ## ## ## ## ## ## ## ## ## ## XXOO#
#OOXX ## ## ## ## ## ## ## ## ## ## XXOO#
#OOXX                               XXOO#
#OOXX ## ## ## ## ## ## ## ## ## ## XXOO#
#OOXX ## ## ## ## ## ## ## ## ## ## XXOO#
#OOXX            1                  XXOO#
#OOXX ## ## ## ## ## ## ## ## ## ## XXOO#
#OOXX ## ## ## ## ## ## ## ## ## ## XXOO#
#OOXX                               XXOO#
#OOXX ## ## ## ## ## ## ## ## ## ## XXOO#
#OOXX ## ## ## ## ## ## ## ## ## ## XXOO#
#OOXX                               XXOO#
#OOXX ## ## ## ## ## ## ## ## ## ## XXOO#
#OOXX ## ## ## ## ## ## ## ## ## ## XXOO#
#OOXX            V                  XXOO#
#OOXX ## ## ## ## ## ## ## ## ## ## XXOO#
#OOXX ## ## ## ## ## ## ## ## ## ## XXOO#
#OOXX                               XXOO#
#OOXX ## ## ## ## ## ## ## ## ## ## XXOO#
#OOXX ## ## ## ## ## ## ## ## ## ## XXOO#
#OOXX                               XXOO#
#OOXX ## ## ## ## ## ## ## ## ## ## XXOO#
#OOXX ## ## ## ## ## ## ## ## ## ## XXOO#
#OOXX                               XXOO#
#OOXX ## ## ## ## ## ## ## ## ## ## XXOO#
#OOXX ## ## ## ## ## ## ## ## ## ## XXOO#
#OOXX                               XXOO#
#OOXX ## ## ## ## ## ## ## ## ## ## XXOO#
#OOXX ## ## ## ## ## ## ## ## ## ## XXOO#
#OOXX                               XXOO#
#OOXXXXXXXXXXXXXXXXXXXXXXXXXXXXXXXXXXXOO#
#OOXXXXXXXXXXXXXXXXXXXXXXXXXXXXXXXXXXXOO#
#OOOOOOOOOOOOOOOOOOOOOOOOOOOOOOOOOOOOOOO#
#EOOOOOOOOOOOOOOOOOOOOOOOOOOOOOOOOOOOOOE#
#########################################
