#########################################
#EOOOOOOOOOOOOOOOOOOOOOOOOOOOOOOOOOOOOOE#
#OOOOOOOOOOOOOOOOOOOOOOOOOOOOOOOOOOOOOOO#
#OOXXXXXXXXXXXXXXXXXXXXXXXXXXXXXXXXXXXOO#
#OOXXXXXXXXXXXXXXXXXXXXXXXXXXXXXXXXXXXOO#
#OOXX                              1XXOO#
#OOXX XXXXXXXXXXXXXXXXXXXXXXXXXXXXXXXXOO#
#OOXX XXXXXXXXXXXXXXXXXXXXXXXXXXXXXXXXOO#
#OOXX XX    XX    XX    XX    XX    XXOO#
#OOXX ## ## ## ## ## ## ## ## ## ## XXOO#
#OOXX ## ## ## ## ## ## ## ## ## ## XXOO#
#OOXX    XX    XX    XX    XX    XX XXOO#
#OOXXXXXXXXXXXXXXXXXXXXXXXXXXXXXXXX XXOO#
#OOXXXXXXXXXXXXXXXXXXXXXXXXXXXXXXXX XXOO#
#OOXXXXXXXXXXXXXX             XXX   XXOO#
#OOXX          ## ##XXXXXXX## XXX ##XXOO#
#OOXX ##XXXXXX ## ##XXXXXXX## XXX ##XXOO#
#OOXX ##XXXXXX    XX          XXX   XXOO#
#OOXX       XXXXXXXX ##XXXXXXXXXX## XXOO#
#OOXXXXXX## XXXXXXXX ##XXXXXXXXXX## XXOO#
#OOXX    ## XXXXXXXX                XXOO#
#OOXX ## ## XXXXXXXXXXXXXXXXXXXXXXXXXXOO#
#OOXX ## ## XXXXXXXXXXXXXXXXXXXXXXXXXXOO#
#OOXX XX    XX                   XXXXXOO#
#OOXX ##XXXX## ##XXXXXXXXXXXXX## ##XXXOO#
#OOXX ##XXXX## ##XXXXXXXXXXXXX## ##XXXOO#
#OOXX          XX             XX    XXOO#
#OOXXXXXXXXXXXXXX ##XXXXXXX## ##X## XXOO#
#OOXXXXXXXXXXXXXX ##XXXXXXX## ##X## XXOO#
#OOXX          XX ##       XX       XXOO#
#OOXX ##XXXX## ## ## ##X## XXXXXXX##XXOO#
#OOXX ##XXXX## ## XX ##X## XXXXXXX##XXOO#
#OOXX XX    XX    XX XX    XXXXX    ##OO#
#OOXX ## ## ##XXXX## XX ##XXXX## ## ##OO#
#OOXX ## ## ##XXXX## XX ##XXXX## ## ##OO#
#OOXX    ##          XX          XXVXXOO#
#OOXXXXXXXXXXXXXXXXXXXXXXXXXXXXXXXXXXXOO#
#OOXXXXXXXXXXXXXXXXXXXXXXXXXXXXXXXXXXXOO#
#OOOOOOOOOOOOOOOOOOOOOOOOOOOOOOOOOOOOOOO#
#EOOOOOOOOOOOOOOOOOOOOOOOOOOOOOOOOOOOOOE#
#########################################
