#########################################
#EOOOOOOOOOOOOOOOOOOOOOOOOOOOOOOOOOOOOOE#
#OOOOOOOOOOOOOOOOOOOOOOOOOOOOOOOOOOOOOOO#
#OOXXXXXXXXXXXXXXXXXXXXXXXXXXXXXXXXXXXOO#
#OOXXXXXXXXXXXXXXXXXXXXXXXXXXXXXXXXXXXOO#
#OOXX1     1     1     1     1     1XXOO#
#OOXX ## ## ## ## ## ## ## ## ## ## XXOO#
#OOXX ## ## ## ## ## ## ## ## ## ## XXOO#
#OOXX1     1     1     1     1     1XXOO#
#OOXX ## ## ## ## ## ## ## ## ## ## XXOO#
#OOXX ## ## ## ## ## ## ## ## ## ## XXOO#
#OOXX1     1     1     1     1     1XXOO#
#OOXX ## ## ## ## ## ## ## ## ## ## XXOO#
#OOXX ## ## ## ## ## ## ## ## ## ## XXOO#
#OOXX1     1     1     1     1     1XXOO#
#OOXX ## ## ## ## ## ## ## ## ## ## XXOO#
#OOXX ## ## ## ## ## ## ## ## ## ## XXOO#
#OOXX1     1     1     1     1     1XXOO#
#OOXX ## ## ## ## ## ## ## ## ## ## XXOO#
#OOXX ## ## ## ## ## ## ## ## ## ## XXOO#
#OOXX1     1     V     1     1     1XXOO#
#OOXX ## ## ## ## ## ## ## ## ## ## XXOO#
#OOXX ## ## ## ## ## ## ## ## ## ## XXOO#
#OOXX1     1     1     1     1     1XXOO#
#OOXX ## ## ## ## ## ## ## ## ## ## XXOO#
#OOXX ## ## ## ## ## ## ## ## ## ## XXOO#
#OOXX1     1     1     1     1     1XXOO#
#OOXX ## ## ## ## ## ## ## ## ## ## XXOO#
#OOXX ## ## ## ## ## ## ## ## ## ## XXOO#
#OOXX1     1     1     1     1     1XXOO#
#OOXX ## ## ## ## ## ## ## ## ## ## XXOO#
#OOXX ## ## ## ## ## ## ## ## ## ## XXOO#
#OOXX1     1     1     1     1     1XXOO#
#OOXX ## ## ## ## ## ## ## ## ## ## XXOO#
#OOXX ## ## ## ## ## ## ## ## ## ## XXOO#
#OOXX1     1     1     1     1     1XXOO#
#OOXXXXXXXXXXXXXXXXXXXXXXXXXXXXXXXXXXXOO#
#OOXXXXXXXXXXXXXXXXXXXXXXXXXXXXXXXXXXXOO#
#OOOOOOOOOOOOOOOOOOOOOOOOOOOOOOOOOOOOOOO#
#EOOOOOOOOOOOOOOOOOOOOOOOOOOOOOOOOOOOOOE#
#########################################
