#########################################
#E                                     E#
#                                       #
#  ###################################  #
#  ###################################  #
#  ##                               ##  #
#  ##                               ##  #
#  ##                               ##  #
#  ##                               ##  #
#  ##                               ##  #
#  ##                               ##  #
#  ##                               ##  #
#  ##         1111111111111         ##  #
#  ##        111111111111111        ##  #
#  ##       1               1       ##  #
#  ##      11               11      ##  #
#  ##      11               11      ##  #
#  ##      11               11      ##  #
#  ##      11               11      ##  #
#  ##      11               11      ##  #
#  ##      11       V       11      ##  #
#  ##      11               11      ##  #
#  ##      11               11      ##  #
#  ##      11               11      ##  #
#  ##      11               11      ##  #
#  ##      11               11      ##  #
#  ##       1               1       ##  #
#  ##        111111111111111        ##  #
#  ##         1111111111111         ##  #
#  ##                               ##  #
#  ##                               ##  #
#  ##                               ##  #
#  ##                               ##  #
#  ##                               ##  #
#  ##                               ##  #
#  ##                               ##  #
#  ###################################  #
#  ###################################  #
#                                       #
#E                                     E#
#########################################
