#########################################
#EOOOOOOOOOOOOOOOOOOOOOOOOOOOOOOOOOOOOOE#
#OOOOOOOOOOOOOOOOOOOOOOOOOOOOOOOOOOOOOOO#
#OOXXXXXXXXXXXXXXXXXXXXXXXXXXXXXXXXXXXOO#
#OOXXXXXXXXXXXXXXXXXXXXXXXXXXXXXXXXXXXOO#
#OOXX            1                  XXOO#
#OOXX ## ## ## ## ## ## ## ## ## ## XXOO#
#OOXX ## ## ## ## ## ## ## ## ## ## XXOO#
#OOXX      1                 1      XXOO#
#OOXX ## ## ## ## ## ## ## ## ## ## XXOO#
#OOXX ## ## ## ## ## ## ## ## ## ## XXOO#
#OOXX            1                  XXOO#
#OOXX ## ## ## ## ## ## ## ## ## ## XXOO#
#OOXX ## ## ## ## ## ## ## ## ## ## XXOO#
#OOXX      1                 1      XXOO#
#OOXX ## ## ## ## ## ## ## ## ## ## XXOO#
#OOXX ## ## ## ## ## ## ## ## ## ## XXOO#
#OOXX            1                  XXOO#
#OOXX ## ## ## ## ## ## ## ## ## ## XXOO#
#OOXX ## ## ## ## ## ## ## ## ## ## XXOO#
#OOXX            V                  XXOO#
#OOXX ## ## ## ## ## ## ## ## ## ## XXOO#
#OOXX ## ## ## ## ## ## ## ## ## ## XXOO#
#OOXX            1                  XXOO#
#OOXX ## ## ## ## ## ## ## ## ## ## XXOO#
#OOXX ## ## ## ## ## ## ## ## ## ## XXOO#
#OOXX      1                 1      XXOO#
#OOXX ## ## ## ## ## ## ## ## ## ## XXOO#
#OOXX ## ## ## ## ## ## ## ## ## ## XXOO#
#OOXX            1                  XXOO#
#OOXX ## ## ## ## ## ## ## ## ## ## XXOO#
#OOXX ## ## ## ## ## ## ## ## ## ## XXOO#
#OOXX      1                 1      XXOO#
#OOXX ## ## ## ## ## ## ## ## ## ## XXOO#
#OOXX ## ## ## ## ## ## ## ## ## ## XXOO#
#OOXX            1                  XXOO#
#OOXXXXXXXXXXXXXXXXXXXXXXXXXXXXXXXXXXXOO#
#OOXXXXXXXXXXXXXXXXXXXXXXXXXXXXXXXXXXXOO#
#OOOOOOOOOOOOOOOOOOOOOOOOOOOOOOOOOOOOOOO#
#EOOOOOOOOOOOOOOOOOOOOOOOOOOOOOOOOOOOOOE#
#########################################
