#########################################
#EOOOOOOOOOOOOOOOOOOOOOOOOOOOOOOOOOOOOOE#
#OOOOOOOOOOOOOOOOOOOOOOOOOOOOOOOOOOOOOOO#
#OOXXXXXXXXXXXXXXXXXXXXXXXXXXXXXXXXXXXOO#
#OOXXXXXXXXXXXXXXXXXXXXXXXXXXXXXXXXXXXOO#
#OOXX1              1              1XXOO#
#OOXX XXXXX ## ## ## ## ## ## XXXXX XXOO#
#OOXX XXXXX ## ## ## ## ## ## XXXXX XXOO#
#OOXX1     1                 1     1XXOO#
#OOXX ## XXXXX ## ## ## ## XXXXX ## XXOO#
#OOXX ## XXXXX ## ## ## ## XXXXX ## XXOO#
#OOXX      1  1  1     1  1  1      XXOO#
#OOXX ## ## XXXXX ## ## XXXXX ## ## XXOO#
#OOXX ## ## XXXXX ## ## XXXXX ## ## XXOO#
#OOXX            1     1            XXOO#
#OOXX ## ## ## ## XXXXX ## ## ## ## XXOO#
#OOXX ## ## ## ## XXXXX ## ## ## ## XXOO#
#OOXX            1  1  1            XXOO#
#OOXX ## ## ## ## XXXXX ## ## ## ## XXOO#
#OOXX ## ## ## ## XXXXX ## ## ## ## XXOO#
#OOXX            1  1  1            XXOO#
#OOXX ## ## ## ## XXXXX ## ## ## ## XXOO#
#OOXX ## ## ## ## XXXXX ## ## ## ## XXOO#
#OOXX            1  1  1            XXOO#
#OOXX ## ## ## ## XXXXX ## ## ## ## XXOO#
#OOXX ## ## ## ## XXXXX ## ## ## ## XXOO#
#OOXX      1  1  1     1  1  1      XXOO#
#OOXX ## ## XXXXX ## ## XXXXX ## ## XXOO#
#OOXX ## ## XXXXX ## ## XXXXX ## ## XXOO#
#OOXX      1                 1      XXOO#
#OOXX ## XXXXX ## ## ## ## XXXXX ## XXOO#
#OOXX ## XXXXX ## ## ## ## XXXXX ## XXOO#
#OOXX1                       1     1XXOO#
#OOXX XXXXX ## ## ## ## ## ## XXXXX XXOO#
#OOXX XXXXX ## ## ## ## ## ## XXXXX XXOO#
#OOXX1              V              1XXOO#
#OOXXXXXXXXXXXXXXXXXXXXXXXXXXXXXXXXXXXOO#
#OOXXXXXXXXXXXXXXXXXXXXXXXXXXXXXXXXXXXOO#
#OOOOOOOOOOOOOOOOOOOOOOOOOOOOOOOOOOOOOOO#
#EOOOOOOOOOOOOOOOOOOOOOOOOOOOOOOOOOOOOOE#
#########################################
