#########################################
#EOOOOOOOOOOOOOOOOOOOOOOOOOOOOOOOOOOOOOE#
#OOOOOOOOOOOOOOOOOOOOOOOOOOOOOOOOOOOOOOO#
#OOXXXXXXXXXXXXXXXXXXXXXXXXXXXXXXXXXXXOO#
#OOXXXXXXXXXXXXXXXXXXXXXXXXXXXXXXXXXXXOO#
#OOXX1     1     1     1     1     1XXOO#
#OOXX ## ## ## ## ## ## ## ## ## ## XXOO#
#OOXX ## ## ## ## ## ## ## ## ## ## XXOO#
#OOXX      1                 1      XXOO#
#OOXX ## ## ## ## ## ## ## ## ## ## XXOO#
#OOXX ## ## ## ## ## ## ## ## ## ## XXOO#
#OOXX1     1     1     1     1     1XXOO#
#OOXX ## ## ## ## ## ## ## ## ## ## XXOO#
#OOXX ## ## ## ## ## ## ## ## ## ## XXOO#
#OOXX      1                 1      XXOO#
#OOXX ## ## ## ## ## ## ## ## ## ## XXOO#
#OOXX ## ## ## ## ## ## ## ## ## ## XXOO#
#OOXX1     1     1     1     1     1XXOO#
#OOXX ## ## ## ## ## ## ## ## ## ## XXOO#
#OOXX ## ## ## ## ## ## ## ## ## ## XXOO#
#OOXX            V                  XXOO#
#OOXX ## ## ## ## ## ## ## ## ## ## XXOO#
#OOXX ## ## ## ## ## ## ## ## ## ## XXOO#
#OOXX1     1     1     1     1     1XXOO#
#OOXX ## ## ## ## ## ## ## ## ## ## XXOO#
#OOXX ## ## ## ## ## ## ## ## ## ## XXOO#
#OOXX      1                 1      XXOO#
#OOXX ## ## ## ## ## ## ## ## ## ## XXOO#
#OOXX ## ## ## ## ## ## ## ## ## ## XXOO#
#OOXX1     1     1     1     1     1XXOO#
#OOXX ## ## ## ## ## ## ## ## ## ## XXOO#
#OOXX ## ## ## ## ## ## ## ## ## ## XXOO#
#OOXX      1                 1      XXOO#
#OOXX ## ## ## ## ## ## ## ## ## ## XXOO#
#OOXX ## ## ## ## ## ## ## ## ## ## XXOO#
#OOXX1     1     1           1     1XXOO#
#OOXXXXXXXXXXXXXXXXXXXXXXXXXXXXXXXXXXXOO#
#OOXXXXXXXXXXXXXXXXXXXXXXXXXXXXXXXXXXXOO#
#OOOOOOOOOOOOOOOOOOOOOOOOOOOOOOOOOOOOOOO#
#EOOOOOOOOOOOOOOOOOOOOOOOOOOOOOOOOOOOOOE#
#########################################
