#########################################
#E                                     E#
#                                       #
#  ###################################  #
#  ###################################  #
#  ##1     1     1     1     1     1##  #
#  ## ## ## ## ## ## ## ## ## ## ## ##  #
#  ## ## ## ## ## ## ## ## ## ## ## ##  #
#  ##1     1     1     1     1     1##  #
#  ## ## ## ## ## ## ## ## ## ## ## ##  #
#  ## ## ## ## ## ## ## ## ## ## ## ##  #
#  ##1     1     1     1     1     1##  #
#  ## ## ## ## ## ## ## ## ## ## ## ##  #
#  ## ## ## ## ## ## ## ## ## ## ## ##  #
#  ##1     1     1     1     1     1##  #
#  ## ## ## ## ## ## ## ## ## ## ## ##  #
#  ## ## ## ## ## ## ## ## ## ## ## ##  #
#  ##1     1     1     1     1     1##  #
#  ## ## ## ## ## ## ## ## ## ## ## ##  #
#  ## ## ## ## ## ## ## ## ## ## ## ##  #
#  ##1     1     V     1     1     1##  #
#  ## ## ## ## ## ## ## ## ## ## ## ##  #
#  ## ## ## ## ## ## ## ## ## ## ## ##  #
#  ##1     1     1     1     1     1##  #
#  ## ## ## ## ## ## ## ## ## ## ## ##  #
#  ## ## ## ## ## ## ## ## ## ## ## ##  #
#  ##1     1     1     1     1     1##  #
#  ## ## ## ## ## ## ## ## ## ## ## ##  #
#  ## ## ## ## ## ## ## ## ## ## ## ##  #
#  ##1     1     1     1     1     1##  #
#  ## ## ## ## ## ## ## ## ## ## ## ##  #
#  ## ## ## ## ## ## ## ## ## ## ## ##  #
#  ##1     1     1     1     1     1##  #
#  ## ## ## ## ## ## ## ## ## ## ## ##  #
#  ## ## ## ## ## ## ## ## ## ## ## ##  #
#  ##1     1     1     1     1     1##  #
#  ###################################  #
#  ###################################  #
#                                       #
#E                                     E#
#########################################
