#########################################
#EOOOOOOOOOOOOOOOOOOOOOOOOOOOOOOOOOOOOOE#
#OOOOOOOOOOOOOOOOOOOOOOOOOOOOOOOOOOOOOOO#
#OOXXXXXXXXXXXXXXXXXXXXXXXXXXXXXXXXXXXOO#
#OOXXXXXXXXXXXXXXXXXXXXXXXXXXXXXXXXXXXOO#
#OOXX                               XXOO#
#OOXX                               XXOO#
#OOXX                               XXOO#
#OOXX                               XXOO#
#OOXX                               XXOO#
#OOXX                               XXOO#
#OOXX                               XXOO#
#OOXX         1111111111111         XXOO#
#OOXX        111111111111111        XXOO#
#OOXX       1               1       XXOO#
#OOXX      11               11      XXOO#
#OOXX      11               11      XXOO#
#OOXX      11               11      XXOO#
#OOXX      11               11      XXOO#
#OOXX      11               11      XXOO#
#OOXX      11       V       11      XXOO#
#OOXX      11               11      XXOO#
#OOXX      11               11      XXOO#
#OOXX      11               11      XXOO#
#OOXX      11               11      XXOO#
#OOXX      11               11      XXOO#
#OOXX       1               1       XXOO#
#OOXX        111111111111111        XXOO#
#OOXX         1111111111111         XXOO#
#OOXX                               XXOO#
#OOXX                               XXOO#
#OOXX                               XXOO#
#OOXX                               XXOO#
#OOXX                               XXOO#
#OOXX                               XXOO#
#OOXX                               XXOO#
#OOXXXXXXXXXXXXXXXXXXXXXXXXXXXXXXXXXXXOO#
#OOXXXXXXXXXXXXXXXXXXXXXXXXXXXXXXXXXXXOO#
#OOOOOOOOOOOOOOOOOOOOOOOOOOOOOOOOOOOOOOO#
#EOOOOOOOOOOOOOOOOOOOOOOOOOOOOOOOOOOOOOE#
#########################################
